00 00 00 00 00 00 00 00 00 00 00 00 00 00 00 00 00 00 00 00 00 00 00 00 00 00 00 00 00 00 00 00 
00 04 04 04 04 04 04 04 04 04 04 04 04 04 04 04 04 04 04 04 04 04 04 04 04 04 04 04 04 04 04 00
00 04 01 01 01 02 02 02 01 01 01 02 02 02 01 01 01 02 02 02 01 01 01 02 02 02 01 01 01 02 04 00
00 04 01 01 01 02 02 02 01 01 01 02 02 02 01 01 01 02 02 02 01 01 01 02 02 02 01 01 01 02 04 00
00 04 01 01 01 02 02 02 01 01 01 02 02 02 01 01 01 02 02 02 01 01 01 02 02 02 01 01 01 02 04 00
00 04 02 02 02 01 01 01 02 02 02 01 01 01 02 02 02 01 01 01 02 02 02 01 01 01 02 02 02 01 04 00
00 04 02 02 02 01 01 01 02 02 03 03 03 03 03 03 03 03 01 01 02 02 02 01 01 01 02 02 02 01 04 00
00 04 02 02 02 01 01 01 02 02 02 01 01 01 02 02 02 01 01 01 02 02 02 01 01 01 02 02 02 01 04 00
00 04 01 01 01 02 02 02 01 01 01 02 02 02 01 01 01 02 02 02 01 01 01 02 03 02 01 01 01 02 04 00
00 04 01 01 01 02 02 02 01 01 01 02 02 02 01 01 01 02 02 02 01 01 01 02 03 02 01 01 01 02 04 00
00 04 01 01 01 02 02 02 01 01 01 02 02 02 01 01 01 02 02 02 01 01 01 02 03 02 01 01 01 02 04 00
00 04 02 02 02 01 01 01 02 02 02 01 01 01 02 02 02 01 01 01 02 02 02 01 03 01 02 02 02 01 04 00
00 04 02 02 02 01 01 01 02 02 02 01 01 01 02 02 02 01 01 01 02 02 02 01 03 01 02 02 02 01 04 00
00 04 02 02 02 01 01 01 02 02 02 01 01 01 02 02 02 01 01 01 02 02 02 01 03 01 02 02 02 01 04 00
00 04 01 01 01 02 02 02 01 01 01 02 02 02 01 01 01 02 02 02 01 01 01 02 03 02 01 01 01 02 04 00
00 04 01 01 01 02 02 02 01 01 01 02 02 02 01 01 01 02 02 02 01 01 01 02 03 02 01 01 01 02 04 00
00 04 01 01 01 02 02 02 01 01 01 02 02 02 01 01 01 02 02 02 01 01 01 02 03 02 01 01 01 02 04 00
00 04 02 02 02 01 01 01 02 02 02 01 01 01 02 02 02 01 01 01 02 02 02 01 03 01 02 02 02 01 04 00
00 04 02 02 02 01 01 01 02 02 02 01 01 01 02 02 02 01 01 01 02 02 02 01 01 01 02 02 02 01 04 00
00 04 02 02 02 01 01 01 02 02 02 01 01 01 02 02 02 01 01 01 02 02 02 01 01 01 02 02 02 01 04 00
00 04 01 01 01 02 02 02 01 01 01 02 02 02 01 01 01 02 02 02 01 01 01 02 02 02 01 01 01 02 04 00
00 04 01 01 01 02 02 02 01 01 01 02 02 02 01 01 01 02 02 02 01 01 01 02 02 02 01 01 01 02 04 00
00 04 01 01 01 02 02 02 01 01 01 02 02 02 01 01 01 02 02 02 01 01 01 02 02 02 01 01 01 02 04 00
00 04 02 02 02 01 03 03 03 04 04 04 01 01 02 02 02 01 01 01 02 02 02 01 01 01 02 02 02 01 04 00
00 04 02 02 02 01 01 01 02 02 02 01 01 01 02 02 02 01 01 01 02 02 02 01 01 01 02 02 02 01 04 00
00 04 02 02 02 01 01 01 02 02 02 01 01 01 02 02 02 01 01 01 02 02 02 01 01 01 02 02 02 01 04 00
00 04 01 01 01 02 02 02 01 01 01 02 02 02 01 01 01 02 02 02 01 01 01 02 02 02 01 01 01 02 04 00
00 04 01 01 01 02 02 02 01 01 01 02 02 02 01 01 01 02 02 02 01 01 01 02 02 02 01 01 01 02 04 00
00 04 01 01 01 02 02 02 01 01 01 02 02 02 01 01 01 02 02 02 01 01 01 02 02 02 01 01 01 02 04 00
00 04 02 02 02 01 01 01 02 02 02 01 01 01 02 02 02 01 01 01 02 02 02 01 01 01 02 02 02 01 04 00
00 04 04 04 04 04 04 04 04 04 04 04 04 04 04 04 04 04 04 04 04 04 04 04 04 04 04 04 04 04 04 00
00 00 00 00 00 00 00 00 00 00 00 00 00 00 00 00 00 00 00 00 00 00 00 00 00 00 00 00 00 00 00 00
