00 00 00 00 00 00 00 00 00 00 00 00 00 00 00 00 00 00 00 00 00 00 00 00 00 00 00 00 00 00 00 00 
00 01 02 01 02 01 02 01 02 01 02 01 02 01 02 01 02 01 02 01 02 01 02 01 02 01 02 01 02 01 02 00
00 02 01 02 01 02 01 02 01 02 01 02 01 02 01 02 01 02 01 04 01 02 01 02 01 02 01 02 01 02 01 00
00 01 02 01 02 01 02 01 02 01 02 01 02 01 02 01 02 01 02 04 02 01 02 01 02 01 02 01 02 01 02 00
00 02 01 02 01 02 01 02 01 02 01 02 01 02 01 02 01 02 01 02 01 02 01 02 01 02 01 02 01 02 01 00
00 01 02 01 02 01 02 01 02 01 02 01 02 01 02 01 02 01 02 01 02 01 02 01 02 01 02 01 02 01 02 00
00 02 01 02 01 02 01 02 01 02 01 02 04 02 01 02 01 02 01 02 01 02 01 02 01 02 01 02 01 02 01 00
00 01 02 01 02 01 02 01 02 01 02 01 02 01 02 01 02 01 02 01 02 01 02 01 02 01 02 01 02 01 02 00
00 02 01 02 01 02 01 02 01 02 01 02 01 02 01 02 01 02 01 02 01 02 01 02 01 02 01 02 01 02 01 00
00 01 02 01 02 01 02 01 02 01 02 01 02 01 02 01 02 01 02 01 02 01 02 01 02 01 02 01 02 01 02 00
00 02 01 02 01 02 01 02 01 02 01 02 01 02 01 02 01 02 01 02 01 02 01 02 03 03 03 03 03 03 03 00
00 01 02 01 02 01 02 01 02 01 02 01 02 01 02 01 02 01 02 01 02 01 02 01 03 03 02 01 02 01 02 00
00 02 01 02 01 02 01 02 01 02 01 02 01 02 01 02 01 02 01 02 01 02 01 02 03 02 01 02 01 02 01 00
00 01 02 01 02 01 02 04 04 01 02 01 02 01 02 01 02 01 02 01 02 01 02 01 02 01 02 01 02 01 02 00
00 02 01 02 01 02 01 04 04 02 01 02 01 02 01 02 01 02 01 02 01 02 01 02 03 02 01 02 01 02 01 00
00 01 02 01 02 01 02 01 02 01 02 01 02 01 02 01 02 01 02 01 02 01 02 01 03 01 02 01 02 01 02 00
00 02 01 02 01 02 01 02 01 02 01 02 01 02 01 02 01 02 01 02 01 02 01 02 03 02 01 02 01 02 01 00
00 01 02 01 02 01 02 01 02 01 02 01 02 01 02 01 02 01 02 01 02 01 02 01 03 03 03 01 03 03 03 00
00 02 01 02 01 02 01 02 01 02 01 02 01 02 01 02 01 02 01 02 01 02 01 02 01 02 01 02 01 02 01 00
00 01 02 01 02 01 02 01 02 01 02 01 02 01 02 01 02 01 02 01 02 01 02 01 02 01 02 01 02 01 02 00
00 02 01 02 01 02 01 02 01 02 01 02 01 02 01 02 01 02 01 02 01 02 01 02 01 02 01 02 01 02 01 00
00 01 02 01 02 01 02 01 02 01 03 03 03 01 02 01 02 01 02 01 02 01 02 01 02 01 02 01 02 01 02 00
00 02 01 02 01 02 01 02 01 02 03 03 03 02 01 02 01 02 01 02 01 02 01 02 01 02 01 02 01 02 01 00
00 01 02 01 02 01 02 01 02 01 03 03 03 01 02 01 02 01 02 01 02 01 02 01 02 01 02 01 02 01 02 00
00 02 01 02 01 02 01 02 01 02 01 02 03 03 01 02 01 02 01 02 01 02 01 02 01 02 01 02 01 02 01 00
00 01 02 01 02 01 02 01 02 01 02 01 02 03 03 01 02 01 02 01 02 01 02 01 02 01 02 01 02 01 02 00
00 02 03 03 03 02 01 02 01 02 01 02 01 03 03 02 01 02 01 02 01 02 01 02 01 02 01 02 01 02 01 00
00 01 03 04 03 01 02 01 02 01 02 01 02 03 03 01 02 01 02 01 02 01 02 01 02 01 04 01 02 01 02 00
00 02 03 04 03 02 01 02 01 02 01 02 01 02 03 02 01 02 01 02 01 02 01 02 01 02 04 02 01 02 01 00
00 01 03 03 03 01 02 01 02 01 02 01 02 01 03 01 02 01 02 01 02 01 02 01 02 01 04 01 02 01 02 00
00 02 01 02 01 02 01 02 01 02 01 02 01 02 03 02 01 02 01 02 01 02 01 02 01 02 01 02 01 02 01 00
00 00 00 00 00 00 00 00 00 00 00 00 00 00 00 00 00 00 00 00 00 00 00 00 00 00 00 00 00 00 00 00 
